*********************************************************
*******                                  ********** *****
******* *************** **************** ********** *****
******* *************** ***            * ***        *****
P       *************** **  *********  * *** ****** *****
******* ***          ** *  **********        ****** *****
******* *** ******** **   ************************* *****
******* *** ******** ****************************** *****
***     *** **                         ************ *****
*** ******* ** **** ***** ************************* *****
*** ******* ** **** *****                    ******  **** 
*** ********** **** *******************************  ****
***            **** ******************************** ****
******** ********** ****************  ************** ****
******** ********** ****************       ********* ****
********      ***** ****************  **** ********* ****
*******************                   **** ********* ****
****************************************** ********* ****
****************************************** **************
******************************************              T
*********************************************************                                 